1111111111111111111
1P00000C000C0000001
1011111111111111101
1010000000000000101
1010111110001110001
101010000C000000101
1010111110111010101
1111111101111010101
1000000100000010101
1011110111111110101
1010000000000000101
10101111111010101E1
1111111111111111111
