1111111111111111111111111111111
10000000000C0000000011111111111
1011111111111111100010000000001
1010000000000000101110111111101
1010111110001110000010000000101
101010000C000000101011111010101
1010111110111010101111110101011
1111111101111010100000000100011
1000000100000010111111110111111
1011110111111110110000010000001
1010000000000000101111111111101
1010111111101010100000000000101
1010100000101010111111111110101
1010111010101010000000000010101
1P10001010101111111111111010101
1111111010100000000000001010101
10000000101111111111111010100E1
1111111111111111111111111111111