1111
1C11
1P01
1001
1001
1001
1CC1
1CE1
1111
1111